WWWWWWWWWWWWWWWWWWWWWWWWWWWWWWWWWWWWWWWWWWWWWWWWWWWWWWWWWWWWWWWWWWWWWWWWWWWWWWWWWWWWWWWWWWWWWWWWWWWWW
W                   W                                          W                                    W
W   S               W                                          W                                    W
W                   W                                          W                                    W
W                   W                                          W                                    W
W         W         W                WWWWWWWWWWWWWWWW          W                                    W
W         W         W       W        W                         W        WWWWWWWWWWWWWW       WWWWWWWW
W         W         W       W        W                         W        W            W              W
W         W                 W        W                         W        W            W              W
W         W                 W        W                         W        W            W              W
W         W                 W        W       WWWWWWWWWWWWWWWWWWW        W            W              W
W         W                 W        W                         W        W      W     WWWWWWWWW      W
W         WWWWWWWWWWWWWWWWWWW        W                         W        W      W     W              W
W                           W        W                         W        W      W     W              W
W                           W        W                         W        W      W     W              W
W                           W        W                         W        W      W     W              W
W                           W        WWWWWWWWWWWWWWWWWW        W        W      W     W              W
W                           W                         W        W        W      W     W              W
W                           W                         W        W        W      W     W              W
W                           W                         W        W        W      W     W     WWW      W
WWWWWWWWWWWWWW              W                         W        W        W      W     W     W W      W
W                           WWWWWWWWWWWWWWWWWWW       W        W        W      W     W     W W      W
W                           W                         W        W        W      W     W     W W      W
W                           W                         W        W        W      W     W     w W      W
W                           W                         W        W        W      W     W     W W      W
W                           W                         W        W        W      W     W     W W      W
W                           W        WWWWWWWWWW       W        W        W      W     W     W W      W
W                           W        W                W        W        W      W     W     W WWWWWWWW
W                           W        W                W        W        W      W     W     w        W
W                           W        W                W        W        W      W     W     W        W
W            WWWWWWWWWWWWWWWW        W                W        W        W      W     W     W        W
W                           W        W        WWWWWWWWW        W        W      W     W     w        W
W                           W        W        W                W        W      W     W     W        W
W                           W        W        W                W        W      W     W     WWWWWWWWWW
W                           W        W        W                W        W      W     W              W
W                           W        W        W                W        W      W     W              W
W                           W        W        WWWWWWWWWWWWWWWWWW        W      W     W              W
W                           W        W                                  W      W     W              W
W                           W        W                                  W      W     W              W
W                           W        W                                  W      W     WWWWWW         W
W                           W        W                                  W      W     W    W         W
W                           W        W                                  W      W     W    W         W
WWWWWWWWWWWWWWW             W        WWWWWWWWWWWWWWWWWWWWWWWWWWWWWWWWWWWW      W     W    W         W
W                           W                  W                               W          W         W
W                           W                  W                               W          W         W
W                           W   T   T    T     W                               W          w         W
W                           W                  W                               W          w         W
W                           W                  W                               W          W         W
W                           W                  W                               W          w         W
W                           W                  W                               W          W         W
W                           W                  w                               W          w    E    W
W                           W        W         W                               W          w         W
W                           W   G    W         W                               W          W         W
W                           W        W                                         W          W         W
W                           W        W                                         W          W         W
WWWWWWWWWWWWWWWWWWWWWWWWWWWWWWWWWWWWWWWWWWWWWWWWWWWWWWWWWWWWWWWWWWWWWWWWWWWWWWWWWWWWWWWWWWWWWWWWWWWWW
