WWWWWWWWWWWWWWWWWWWWWWWWWWWWWWWWWWWWWWWWWWWWWWWWWWWWWWWWWWWWWWWWWWWWWWWWWWWWWWWWWWWWWWWWWWWWWWWWWWWWW
W                   W                                          W                                    W
W   S               W                                          W                                    W
W                   W                                          W                  2                 W
W                   W                                          W                                    W
W         W         W                WWWWWWWWWWWWWWWW          W                                    W
W         W         W       W        W                         W        WWWWWWWWWWWWWW       WWWWWWWW
W         W         W       W        W                         W        W            W              W
W         W                 W        W                         W        W      1     W              W
W         W        1        W        W                         W        W            W              W
W         W                 W        W       WWWWWWWWWWWWWWWWWWW        W            W              W
W         W                 W        W                         W        W      W     WWWWWWWWW      W
W         WWWWWWWWWWWWWWWWWWW        W                         W        W      W     W              W
W                           W        W            T            W        W      W     W              W
W                           W        W                         W        W      W     W              W
W                           W        W                         W        W      W     W              W
W                           W        WWWWWWWWWWWWWWWWWW        W        W      W     W              W
W                           W                         W        W        W      W     W              W
W                           W                         W        W        W      W     W              W
W                           W                         W        W        W      W     W     WWW      W
WWWWWWWWWWWWWW              W                         W        W        W      W     W     W W      W
W                           WWWWWWWWWWWWWWWWWWW       W        W        W      W     W     W W      W
W                           W                         W        W        W      W     W     W W      W
W                           W                         W        W        W      W     W     W W      W
W                           W                         W        W        W      W     W     W W      W
W             T             W                         W        W        W      W     W     W W      W
W                           W        WWWWWWWWWW       W        W        W      W     W     W W      W
W                           W        W                W        W        W      W     W     W WWWWWWWW
W                           W        W                W        W        W      W     W     W        W
W                           W        W                W        W        W      W     W     W        W
W            WWWWWWWWWWWWWWWW        W                W        W        W      W     W     W    T   W
W                           W        W        WWWWWWWWW        W        W      W     W     W        W
W                           W        W        W                W        W      W     W     W        W
W                           W        W        W                W        W      W     W     WWWWWWWWWW
W                           W        W        W                W        W      W     W              W
W                           W        W        W                W        W      W     W              W
W             1             W        W        WWWWWWWWWWWWWWWWWW        W      W     W              W
W                           W        W                                  W      W     W              W
W                           W        W                                  W      W     W     KC       W
W                           W        W                 1                W      W     WWWWWW         W
W                           W        W                                  W      W     W    W         W
W                           W        W                                  W      W     W    W         W
WWWWWWWWWWWWWWW             W        WWWWWWWWWWWWWWWWWWWWWWWWWWWWWWWWWWWW      W     W    W         W
W                           W                  W                               W          W         W
W                           W                  W                               W          W         W
W                           W   T    T    T    W                               W          W         W
W                           W                  W                               W          W         W
W                           W                  W                               W          W         W
W                           W                  W                               W          W         W
W             T             W                  W               3               W     T    W         W
W                           W                  W                               W          W    E    W
W                           W        W                                         W          W         W
W                           W   G    W                                         W          W         W
W                           W        W                                         W          W         W
W                           W        W                                         W          W         W
WWWWWWWWWWWWWWWWWWWWWWWWWWWWWWWWWWWWWWWWWWWWWWWWWWWWWWWWWWWWWWWWWWWWWWWWWWWWWWWWWWWWWWWWWWWWWWWWWWWWW
