WWWWWWWWWWWWWWWWWWWWWWWWWWWWWWWWWWWWWWWWWWWWWWWWWWWWWWWWWWWWWWWWWWWWWWWWWWWWWWWWWWWWWWWWWWWWWWWWWWWWW
W                                                                                                   W
W                                                  S                                                W
W                                                                                                   W
W                                                                                                   W
W    WWWWWWWWWWWWWWWWWWWW    WWWWWWWWWWWWWWWWWWWWWWWWWWWWWWWWWWWWWWWWW      WWWWWWWWWWWWWWWWWWWW    W
W    W         W                             W                                                 W    W
W    W         W                             W                                                 W    W
W    W         W                             W                                                 W    W
W    W         W                             W                                                 W    W
W    W    WWWWWWWWWWWWWWWWWWWWW    WWWWWWWWWWWWWWWW    WWWWWWWWWWWWWWWWWWWWWWWWWWWWWWWWWWWWWWWWW    W
W              W                       W                                                  W    W    W
W              W                       W                                                  W    W    W
W              W                       W                                                  W    W    W
W              W                       W                                                  W    W    W
W    W    W    WWWWWWWWWWWWWWWWWWWWWWWWWWWWWWWWWWWWWWWWW    WWWWWWWWWWWWWWWWWWWWWWWWWW    W    WWWWWW
W    W    W    W                                                                     W    W         W
W    W    W    W                                                                     W    W         W
W    W    W    W                                                                     W    W    3    W
W    W    W    W                                                                     W    W         W
WWWWWW    W    W    W    WWWWWWWWWWWWWWWWWWWWWWWWWWWWWWWWWWWWWWWWWWWWWWWWWWWWWWWWWWWWW    W    W    W
W    W    W    W    W    W              W    W              W         W              W    W    W    W
W    W    W    W    W    W              W    WWWWWWWWWWWWWWWW         W              W    W    W    W
W    W    W    W    W    W              W    W              W         W              W    W    W    W
W    W    W    W    W    W              W    W              W         W              W    W    W    W
W    W    WWWWWW    W    WWWW    WWW    W    W    E         WWWWWWWWWWWWWWWWWWWWW    W    W    WWWWWW
W    W    W    W    W    W         W    W    W              W                   W    W    W    W    W
W    W    W    W    W    W         W    W    W         W    W                   W    W    W    W    W
W    W    W    W    W    W         W    W    W         W    W                   W    W    W    W    W
W    W    W    W    W    W         W    W    W         W    W                   W    W    W    W    W
W    W    W    WWWWWW    W    WWWWWW    WWWWWWWWWWWWWWWW    WWWWWWWWWWW    W    W    WWWWWW    W    W
W    W    W    W    W    W    W    W                                  W    W    W              W    W
W    W    W    W    W    W    W    W ^                                W    W    W              W    W
W    W    W    W    W    W    W    W                                  W    W    W              W    W
W    W    W    W    W    W    W    W                                  W    W    W              W    W
W    W    W    W    WWWWWW    WWWWWWWWWWWWWWWWWWWWWWWWWWWWWWWWWWWWWWWWWWWWWW    WWWWWWWWWWW    W    W
W    W    W    W         W                   W                                  W         W    W    W
W    W    W    W         W                   W                                  W         W    W    W
W    W    W    W         W                   W                                  W         W    W    W
W    W    W    W         W                   W                                  W         W    W    W
W    W    W    WWWWWW    WWWWWWWWWWWWWWWW    WWWWWWWWWWWWWWWWWWWWW    WWWWWWWWWWW    W    W    W    W
W    W    W         W                                                                W    W    W    W
W    W    W         W                                                                W    W    W    W
W    W    W         W                                                                W    W    W    W
W    W    W         W                                                                W    W    W    W
W    W    WWWWWW    WWWWWW    WWWWWWWWWWWWWWWWWWWWWWWWWWWWWWWWWWWWWWWWWWWWWWWWWWWWWWWW ^  W    W    W
W    W                                            W                                                 W
W    W                                            W                                                 W
W    W                                            W                                                 W
W    W                                            W                                                 W
W    WWWWWWWWWWWWWWWWWWWWWWWWWWWWWW     WWWWWWWWWWWWWWWWWWWW    WWWWWWWWWWWWWWWWWWWWWWWWWWWWWWWW    W
W                                                                                           W       W
W                                                                                           W       W
W                                                                  G                        W       W
W                                                                                           W       W
W                                                                                           W       W   
W                                                                                           W       W
WWWWWWWWWWWWWWWWWWWWWWWWWWWWWWWWWWWWWWWWWWWWWWWWWWWWWWWWWWWWWWWWWWWWWWWWWWWWWWWWWWWWWWWWWWWWWWWWWWWWW

