WWWWWWWWWWWWWWWWWWWWWWWWWWWWWWWWWWWWWWWWWWWWWWWWWWWWWWWWWWWWWWWWWWWWWWWWWWWWWWWWWWWWWWWWWWWWWWWWWWWWW
W                      W             W                         W                W                   W
W                      W             W                         W                W                   W
W                      W             W                         W                W                   W
W                      W             W                         W                W                   W
W                      WWWWWWW       W                         W                WWWW     WWWWWWWWWWWW
WWWWWWWW      W              W       W          W       WWWWWWWWWWWWWWWWWWW              W   W      W                 
W      W      W              W       W          W              W                         W   W      W
W      W      W              W       W          W              W                       WWWWWWWWWWWWWW
W      W      W                                 W           3  W                        W     W     W
W      W      WWWWWWWWW                         W              W                        W     W   E W
W      W              W                         WWWWWWWWWWWWWWWWWWWWWWWWWWWWWW          W     W     W
W      W              W                                        W              KC        W     W     W
W      W              W                                        W                        W     W     W
W      W              WWWWWWWWWWWWWWWW                         W                        WWWWWWW     W
W      W                             W                         W                        W     W     W
W      WWWWWW                        W                         W                        W     W     W
W                                    W                         W                        W     W     W
W                                    WWWWWWWWWWWWWWWWWWWWWWWWWWW                        W     W     W
W                     WWWWWWWWWWWWWWWW                                           WWWWWWWWWWWWWW     W
WWWW                                 W                                                   W    W     W
W                                    W                                                   W     KC   W
W                                    W                                                   W          W
W                                    W                                                              W
W                                    W                                                              W
WWWWWWWWWWWWWWWWWWWWWWWWW            W                                                              W
W                                 JX                                                                W
W                                                                                   G               W
W                                                                                         W         W
W          WWWWWWWWWWW                                                                    W         W
W          W         W                                                                    W         W
W          W         W                                                                    W         W
W          W    2    W                                                                    W         W
W          W         W                                                                    W         W
W          W         W                                                          W         W         W
W          WWWWWWWWWWW            LV                                            W         W         W
W                                    WWWWWWWWWWWWWWWWWWWWW                WWWWWWW         W    T    W
W                                    W               W                          W         W         W
W                                    W               W                          W         W         W
W                                    W               W                          WWWWWWWWWWWWWWWWWWWWW
W                                    W               W              WWWWWWWWWWWWW                   W
WWWWWWWWWWWWWWWWWWWWWWWWW            W               W                          W                   W
W                       W            W               W                          W             T     W
W                       W            W                                          W                   W
W                       W            W                                          W                   W
W                       W            W                                                              W
W        WWWWWWWW                    W                                                              W
W        W                           W                                                    WWWWWWWWWWW
W        W                           WWWWWWWWWWWWWWWWWWWWWWWWWWW                                    W
W        W                                                                                          W
W        WWWWWWWWWWWWWWWWWWWWW                                                  W                   W
W                                                                               W                   W 
W   S                                                                           W             T     W
W                                       W                      W                W                   W
W                                       W                      W                W                   W
WWWWWWWWWWWWWWWWWWWWWWWWWWWWWWWWWWWWWWWWWWWWWWWWWWWWWWWWWWWWWWWWWWWWWWWWWWWWWWWWWWWWWWWWWWWWWWWWWWWWW

