WWWWWWWWWWWWWWWWWWWWWWWWWWWWWWWWWWWWWWWWWWWWWWWWWWWWWWWWWWWWWWWWWWWWWWWWWWWWWWWWWWWWWWWWWWWWWWWWWWWWW
W                     W              W            W            W                                    W
W                     W              W            W            W                                    W
W                     W              W     G      W     E      W                                    W
W                     W              W            W            W                                    W
W                     W              W            W            W                                    W
W                     W              W            W            W                                    W
W                     W              W                         W                                    W
W                     W              W                         W                                    W
W                     W              W                         W                                    W
W                     W              W                         W                                    W
W                     W              W            W            W                                    W
W                     W              W            W            W                                    W
W                     W              W            W            W                                    W
W                     W              W            W            W                                    W
W                     W              W                         W                                    W
W                     W              W                         W                                    W
W                     W              W T T T T T T T T T T T T W                                    W
W                     W              W                         W                                    W
W                     W              W            W            W                                    W
WWWWWWWWWWWWWWWWWWWWWWW              WWWWWWWWWWWWWWWWWWWWWWWWWWW                                    W
W                                    W            W            W                                    W
W                                    W     3      W            W                                    W
W                                    W            W            W                                    W
W                                    W            W            W                                    W
W                                    W            W            W                                    W                        
W                                    W            W            W                                    W
W                                    W            W            W                                    W
W                                    W            W            W                                    W
W                                    W            W            W                                    W
W                                    W            W            W                                    W               
W                                    W            W            W                                    W                 
W                                    W            W            W                                    W       
W                                    W            W            W                                    W
W                                    W            W            W                                    W
W                                    W            W            W                                    W
W                                    W            W            W                                    W
W                                    W            W            W                                    W
W                                    W            W            W                                    W
W                                    WWWWWWWWWWWWWWWWWWWWWWWWWWW                                    W
W                                    WWWWWWWWWWWWWWWWWWWWWWWWWWW                                    W
W                                    W            W            W                                    W
W                                    W     3      W      3     W                                    W
W                                    W            W            W                                    W
W                                    W            W            W                                    W
W                                    W            W            W                                    W
W                                    WWWWWWWWWWWWWWWWWWWWWWWWWWW                                    W
W                                    W            W            W                                    W
W                                    W            W            W                                    W
W                                    W            W            W                                    W
W                                    W                   3     W                                    W
W                                    W                         W                                    W
W                                    W           S             W                                    W
W                                    W                         W                                    W
W                                    W                         W                                    W
WWWWWWWWWWWWWWWWWWWWWWWWWWWWWWWWWWWWWWWWWWWWWWWWWWWWWWWWWWWWWWWWWWWWWWWWWWWWWWWWWWWWWWWWWWWWWWWWWWWWW
