WWWWWWWWWWWWWWWWWWWWWWWWWWWWWWWWWWWWWWWWWWWWWWWWWWWWWWWWWWWWWWWWWWWWWWWWWWWWWWWWWWWWWWWWWWWWWWWWWWWWW
W                     W               W                         W                                   W
W                     W               W                         W                                   W
W                     W               W                         W                                   W
W                     W               W                         W                               E   W
W                     W               W                         W                                   W
W                     W               W                         W                                   W
W                     W               W                         W                                   W
W                     W               W                         W                                   W
W                     W               W                         W                                   W
W                     W               W                         W                                   W
W                     W               W                         W                                   W
W                     W               W                         W                                   W
W                     W               W                         W                                   W
W                     W                                         W                                   W
W                     W                          T              W                                   W
W                     W                                         W                                   W
W                     W                                         W                                   W
W                     W               W                         W                                   W
W                     W       T       W             LV          W                                   W
WWWWWWWWWWWWWWWWWWWWWWW               W               WWWWWWWWWWW                 WWWWWWWWWWWWWWWWWWW
W                                     W               W                                             W
W                                     W               W                                             W
W                                     W               W                                             W
W                                     W                                                             W
W                                     W                                                             W
W   G                                 W                                                             W
W                                     W                                                             W
W                         T           W               W                                             W
W                                     W               W                                             W
W            T                        WWWWWWWWWWWWWWWWW                                             W
W                                                     W                                             W
W                                                     W                                             W
WWWWWWWWWWWWWWWWWWWWWWWWWWWW                          W                                  LV         W
W                          W                          W                                    WWWWWWWWWW
W                          W                          W                                    W        W
W                          W            T             W                                    W        W
W                          W                          W                                    W        W
W                          W                          W                                    W        W
W                          W                          W                                    W        W
W                          W                          W                                    W        W
W                          W                          W                                    W        W
W                          WWWWWWWWWWW                WWWWWWWWWWWWWWWWWW        WWWWWWWWWWWW        W
W                                    W                         W                                    W
W                                    W                         W                                    W
W                                    W                         W                                    W
W                                    W                         W                                    W
W                                    W                         W                                    W
W                                    W                         W                                    W
W                                    W                         W                                    W
W                                    W                         W                                    W
W                                    W                         W                                    W
W                                    W                         W                                    W
W                                    W           S             W                                    W
W                                    W                         W                                    W
W                                    W                         W                                    W
WWWWWWWWWWWWWWWWWWWWWWWWWWWWWWWWWWWWWWWWWWWWWWWWWWWWWWWWWWWWWWWWWWWWWWWWWWWWWWWWWWWWWWWWWWWWWWWWWWWWW

