WWWWWWWWWWWWWWWWWWWWWWWWWWWWWWWWWWWWWWWWWWWWWWWWWWWWWWWWWWWWWWWWWWWWWWWWWWWWWWWWWWWWWWWWWWWWWWWWWWWWW
W                                    W                         W                                    W
W                                    W                         W                                    W
W                                    W                         W                                    W
W                                    W                         W                               E    W
W                                    W                         W                                    W
W                                    W                         W                                    W
W                                    W                         W                                    W
W                                    W                         W                                    W
W                                    W                         W                                    W
W                                    W                         W                                    W
W                                    W                         W                                    W
W                                    W                         W                                    W
W                                    W                         W                                    W
W                                                              W                                    W
W                                                              W                                    W
W                                                              W                                    W
W                                                              W                                    W
W                                    W                         W                                    W
W                                    W                         W                                    W
WWWWWWWWWWWWWWWWWWWWWWWWWWWWWWWWWWWWWW                         WWWWWWWWWWWWW      WWWWWWWWWWWWWWWWWWW
W                                                                                                   W
W                                                                                                   W
W                                                                                                   W
W                                                                                                   W
W                                                                                             G     W
W                                                                                                   W
W                                                                                                   W
W                                                                                                   W
W                                                                                                   W
W                                                                                                   W
W                                                                                                   W
W                                                                                                   W
WWWWWWWWWWWWWWWWWWWWW         WWWWWWWW                         WWWWWWWWWWWWW      WWWWWWWWWWWWWWWWWWW
W                                    W                         W                                    W
W                                    W                         W                                    W
W                                    W                         W                                    W
W                                    W                         W                                    W
W                                    W                         W                                    W
W                                    W                         W                                    W
W                                    W                         W                                    W
W                                    W                         W                                    W
W                                    W                         W                                    W
W                                    W                         W                                    W
W                                    W                         W                                    W
W                                    W                         W                                    W
W                                    W                         W                                    W
W                                    W    N                    W                                    W
W                                    W                         W                                    W
W                                    W                         W                                    W
W                                    W                         W                                    W
W                                    W                         W                                    W
W                                    W                         W                                    W
W                                    W           S             W                                    W
W                                    W                         W                                    W
W                                    W                         W                                    W
WWWWWWWWWWWWWWWWWWWWWWWWWWWWWWWWWWWWWWWWWWWWWWWWWWWWWWWWWWWWWWWWWWWWWWWWWWWWWWWWWWWWWWWWWWWWWWWWWWWWW

