WWWWWWWWWWWWWWWWWWWWWWWWWWWWWWWWWWWWWWWWWWWWWWWWWWWWWWWWWWWWWWWWWWWWWWWWWWWWWWWWWWWWWWWWWWWWWWWWWWWWW
W                         W                                                                         W
W                         W                                                                         W
W                         W                                                               E         W
W                         W                                                                         W
WWWWWWWWWWW         WWWWWWW                                                                         W
W                         WWWWWWWWWWWW          WWWWWWWWWWWWWWWWWWWWW              WWWWWWWWWWWWWWWWWW
W                         W          W                              W                               W
W                         W          W                              W                               W
W                         W          W                              W                               W
WWWWWWWWWWW         W     W          W                              W                               W
W         W         W     W          W                              W                               W
W         W         W     W          WWWWWWWWWWWWWWWWWWWWW          WWWWWWWWWWWWWWWWWWWWWWWWWWWWWWWWW
W         W         W     W          W                   W                                          W
W         W         W     W          W                   W                                          W
W         W         WWWWWWW          W                   W                                          W
W                                    W                   W                                          W
W                                    W                JX WWWWWWWWWW                                 W
W                                    W                            W                                 W
W                                    W                            W                                 W
W             G                      W                            W                                 W
W                                    W                            W                  KC             W
W                                    WWWWWWWWWWWWWWWW             W WWWWWWWWWWWWWWWWW               W
W                                 JX                              W                                 W
W                                                                 W                                 W
W                                                                 W                                 W
W                                                                 W                                 W
W                                                                 W                                 W
W         WWWWWWWWWWWWWWWWWWWWWWWWWWWWWWWWWWWWW                   W                                 W
W                                             W                   W                                 W
W                                             W                   W       LV                        W
W                                             W                   W          WWWWWWWWWWWWWWWWWWWWWWWW
W                                             W                   W          W                      W
W                                             W                   W          W                      W
W                                KC           W                   W          W                2     W
W                    WWWWWWWWWWWW             W                   W          W       LV             W
W                    W                        W                   W          W          W           W
W                    W                        W                   W                     W           W
W                    W                        W                   W                     W           W
W                    W                        W                   W                     W           W
W                    W                        W                   W       LV            W           W
W                    W          WWWWWWWWWWWWWWWWWWWWWWWWWWWWWWWWWWW          WWWWWWWWWWWW           W
W                    W                                            W          W                      W
W                    W                                            W          W                      W
W                    W                                            W          W                      W
W         WWWWWWWWWWWW                                            W    2     W                      W
W         W          WWWWWWWWWWWWWWWWWWWWWWWWWWWW                 W          W          W           W
W         W          W                                            W          W          W           W
W         W          W                                            W          W          W           W
W         W          W                                            W          W          W           W
W         W          W                            WWWWWWWWWWWWWWWWWWWWWWWWWWWW          W           W
W         W          W           W                                                      W           W
W   S     W                      W                                                      W           W
W         W                      W                                                      W           W
W         W                      W                                                      W           W
WWWWWWWWWWWWWWWWWWWWWWWWWWWWWWWWWWWWWWWWWWWWWWWWWWWWWWWWWWWWWWWWWWWWWWWWWWWWWWWWWWWWWWWWWWWWWWWWWWWWW
