WWWWWWWWWWWWWWWWWWWWWWWWWWWWWWWWWWWWWWWWWWWWWWWWWWWWWWWWWWWWWWWWWWWWWWWWWWWWWWWWWWWWWWWWWWWWWWWWWWWWW
W                                    W                         W                                    W
W                                    W                         W                                    W
W                                    W                         W                                    W
W                                    W                         W                                    W
W                                    W                         W                                    W
W                                    W                         W                                    W
W                                    W                         W                                    W
W                                    W                         W                                    W
W                                    W                         W                                    W
W                                    W           2             W                                    W
W                                    W                         W                                    W
W                                    W                         W                                    W
W                                    W                         W                                    W
W                                                              W                                    W
W                                                              W        T                           W
W                                                              W                                    W
W     E                                                        W                                    W
W                                    W                         W                                    W
W                                    W                         W                                    W
WWWWWWWWWWWWWWWWWWWWWWWWWWWWWWWWWWWWWW                         WWWWWWWWWWWWW      WWWWWWWWWWWWWWWWWWW
W                                                            JX                                     W
W                                                                                                   W
W                                                                                                   W
W                                                                                             G     W
W                                                                                                   W
W                                                                                                   W
W                  1                                                                                W
W                                                                                                   W
W                                                                                                   W
W                                                                                                   W
W                                                                                                   W
W                                                            LV                                     W
WWWWWWWWWWWWWWWWWWWWW         WWWWWWWW                 T       WWWWWWWWWWWWW      WWWWWWWWWWWWWWWWWWW
W                                    W                         W                                    W
W                                    W                         W                                    W
W                                    W                         W                                    W
W                                    W                         W                                    W
W                                    W                         W                           T        W
W                                    W                         W                                    W
W                                    W                         W                                    W
W                                    W                         W                                    W
W                                    W                         W                                    W
W                                    W                         W                                    W
W                                    W                         W                                    W
W                                    W                         W                                    W
W                                    W                         W                                    W
W                                    W                         W                                    W
W                                    W                         W                                    W
W                                    W                         W                                    W
W                                    W                         W                                    W
W                                    W                         W                                    W
W                                    W                         W                                    W
W                                    W           S             W                                    W
W                                    W                         W                                    W
W                                    W                         W                                    W
WWWWWWWWWWWWWWWWWWWWWWWWWWWWWWWWWWWWWWWWWWWWWWWWWWWWWWWWWWWWWWWWWWWWWWWWWWWWWWWWWWWWWWWWWWWWWWWWWWWWW

