WWWWWWWWWWWWWWWWWWWWWWWWWWWWWWWWWWWWWWWWWWWWWWWWWWWWWWWWWWWWWWWWWWWWWWWWWWWWWWWWWWWWWWWWWWWWWWWWWWWWW
W                     W               W                         W                                   W
W                     W               W                         W                                   W
W                     W               W                         W                                   W
W                     W               W                         W                               E   W
W                     W               W                         W                                   W
W                     W               W                         W                                   W
W                     W               W                         W                                   W
W                     W               W                         W                                   W
W                     W               W            3            W                                   W
W                     W               W                         W                                   W
W                     W               W                         W                                   W
W                     W               W                         W                                   W
W                     W               W                         W                                   W
W                     W                                         W                                   W
W            T        W                                         W                                   W
W                     W                                         W                                   W
W                     W        T                                W                                   W
W                     W               W                         W                                   W
W                     W               W             LV          W                                   W
WWWWWWW        WWWWWWWW               W               WWWWWWWWWWW                 WWWWWWWWWWWWWWWWWWW
W                                     W               W                                             W
W                                     W         T     W                                             W
W                                     W               W                                             W
W                                     W                                                             W
W                                     W                                                             W
W   G                                 W                                                             W
W                                     W                                                             W
W                                     W               W                                             W
W                                     W               W                     2                       W
W                                     WWWWWWWWWWWWWWWWW                                             W
W                                                     W                                             W
W                                                     W                                             W
WWWWWWW        WWWWWWWWWWWWW                          W                                  LV         W
W                          W                          W                                    WWWWWWWWWW
W                          W                          W                                    W        W
W                          W            T             W                                    W        W
W                          W                          W                                    W        W
W                 T        W                          W                                    W        W
W                          W                          W                                    W        W
W                          W                          W                                    W        W
W                          W          KC              W                                    W        W
W                          WWWWWWWWWWW                WWWWWWWWWWWWWWWWWW        WWWWWWWWWWWW        W
W                                    W                         W                                    W
W                                    W                         W                                    W
W                                    W                         W                                    W
W                                    W                         W                                    W
W                                    W                         W                                    W
W                 1                  W                         W                                    W
W                                    W                         W                                    W
W                                    W                         W                                    W
W                                    W                         W                                    W
W                                    W                         W                                    W
W                                    W           S             W                                    W
W                                    W                         W                                    W
W                                    W                         W                                    W
WWWWWWWWWWWWWWWWWWWWWWWWWWWWWWWWWWWWWWWWWWWWWWWWWWWWWWWWWWWWWWWWWWWWWWWWWWWWWWWWWWWWWWWWWWWWWWWWWWWWW

